::FORM_TECH
btnDno = Last
btnDolje = Down
btnGore = Up
btnVrh = First
btnOk = Ok
chNaziv = Name
chNivo = Level
chPoeni = Points
chIstPrioritet = Priority
chRazUlaganje = Investment
lblFokusirano = Focused
lblIstPoeni = Research points
lblRaspodjela = Distribution
lblRavnomjerno = Even
lblUIstrazivanju = Research
lblURazvoju = In development
naslov = Research & development
tabIst = Research
tabKnjiz = Library
tabOprema = Ship components
tabRaz = Development

nemaTeh = Library is empty
nemaOp = None available

opKatTrup = Hull sizes
opKatMisija = Missions

opCijena = Cost
opSnaga = Power
opVelicina = Size

opTrupVelicina = Size
opTrupProstor = Capacity
opTrupTromost = Inertia
opTrupOklop = Armor base
opTrupStit = Shield base
opTrupPrik = Stealth
opTrupSenzori = Sensor strength
opTrupVelReak = Reactor size
opTrupVelMZ = IS drive size
opTrupVelStit = Shield size

opOruzjeCilj = Aim