::FORM_IGRA
btnEndTurn = Završi &krug
btnFlote = &Flote
btnFlotaPokret = Pokret
btnPlanetInfo = &Detaljnije
btnPoruke := "&Novosti (" # P BR_PORUKA # ")"
btnSpremi = &Spremi
btnTech = &Tehnologije
btnUcitaj = &Učitaj
lblBrojKruga := # D + KRUG 1 # ". krug"
			
flotaObrana = Obrana
zvjNeistrazeno = Neistraženo

::KOLONIJA
Civilna_Gradnja = Civilna gradnja
Vojna_Gradnja = Vojna gradnja
jedInd = ind
lblRazvoj := "Razvoj: "

plBrFarmera = Br. farmera
plBrOdrz = Održavanje
plBrRadnika = Slobodni radnici
plBrRudara = Br. rudara
plMinDubina = Dubina
plMinOstvareno = Ostvareno
plMinPovrsina = Površina
plNenaseljeno = Nenaseljeno
plPopMax = Maksimum
plPopulacija = Populacija
plPromjenaPop = Promjena
plRadnaMjesta = Br. radnih mjesta

gradNikad = Nikad
gradPoKrugu := ? < BR_ZGRADA 10 : # D1 BR_ZGRADA # ? >= BR_ZGRADA 10 : # P BR_ZGRADA # " po krugu"
gradVrijemeDec := "Za " # D1 BR_KRUGOVA # " krug" ? & > INT DECIMALA 1 <= DECIMALA 4 : "a" ? | > DECIMALA 4 = INT DECIMALA 0 : "ova"
gradVrijemePref := "Za " # P BR_KRUGOVA # " krug" ? & > BR_KRUGOVA 20 & > INT MOD BR_KRUGOVA 10 1 < INT MOD BR_KRUGOVA 10 5 : "a" ? | < BR_KRUGOVA 20 | > MOD INT BR_KRUGOVA 10 4 = 0 INT MOD BR_KRUGOVA 10 : "ova"

groupPoStan = Po stanovniku
HranaPoStan = Hrana
IndustrijaPoStan = Industrija
OdrzavanjePoStan = Održavanje
RazvojPoStan = Razvoj
RudePoStan = Rude

::FORM_FLOTA_POKRET
btnOdustani = Odustani
btnPosalji = Pošalji
lblBrPoteza := # D BR_POTEZA # " potez" ? & != % BR_POTEZA 10 1 != BR_POTEZA 11 : "a"
lblBrPotezaNikad = Nikad
lblKolicina = Količina:
lblNazivFlote := # D ID # ". flota"
lblOdrediste = Odredište:
lblPridruzi = Pridruži floti:
naslov = Usmjeravanje brodova

nePridruzuj = Ne pridružuj