::FORM_TECH
btnDno = Na dno
btnDolje = Dolje
btnGore = Gore
btnVrh = Na vrh
btnOk = U redu
chNaziv = Naziv
chNivo = Nivo
chPoeni = Poeni
chIstPrioritet = Prioritet
chRazUlaganje = Ulaganje
lblFokusirano = Fokusirano
lblIstPoeni = Poeni istraživanja
lblRaspodjela = Raspodjela
lblRavnomjerno = Ravnomjerno
lblUIstrazivanju = U istraživanju
lblURazvoju = U razvoju
naslov = Istraživanje i razvoj
tabIst = Istraživanje
tabKnjiz = Knjižnica
tabOprema = Komponente brodova
tabRaz = Razvoj

nemaTeh = Knjiznica prazna
nemaOp = Nema dostupnih

opKatTrup = Veličine trupova
opKatMisija = Misije
opKatStit = Štitovi
opKatSpecOp = Specijalna oprema
opKatOstalo = Ostalo

opCijena = Cijena
opMinVel = Min. velicina
opNeStane = Prevelik za odabran trup
opSnaga = Snaga
opVelicina = Veličina

opTrupVelicina = Veličina
opTrupProstor = Prostor
opTrupTromost = Tromost
opTrupOklop = Baza oklopa
opTrupStit = Baza stita
opTrupPrik = Prikrivanje
opTrupSenzori = Snaga senzora
opTrupVelReak = Veličina reaktora
opTrupVelMZ = Veličina MZ pogona
opTrupRezerv = (rezervirano)

opOruzjeCilj = Ciljanje
opMZbrzina = Max. brzina